平均血红蛋白含量	MCH
平均血红蛋白浓度	MCHC
红细胞平均体积	MCV
平均血小板体积	MPV
嗜碱性粒细胞计数	BAS
嗜碱性粒细胞比率	BAS_P
嗜酸性粒细胞计数	EOS
血红蛋白	HB
血小板分布宽度	PDW
血小板计数	PLT
嗜酸性粒细胞比率	EOS_P
白细胞计数	WBC
中性粒细胞比率	NEUT_P
中性粒细胞计数	NEUT
血小板压积	PCT
红细胞分布宽度	RDW
淋巴细胞计数	LY
淋巴细胞比率	LY_P
单核细胞计数	MONO
红细胞计数	RBC
单核细胞比率	MONO_P
红细胞压积	HCT
性别	Sex
年龄	Age